骨髓瘤	骨质流失	Related-SY	由骨髓瘤引起的骨质流失区域被称为溶骨性病变
致癌病毒的感染	骨髓瘤	Related-SY	暴露于有毒化学物质、原子辐射、干扰或抑制免疫系统的任何事物，或致癌病毒的感染都被认为是造成骨髓瘤的原因或触发因素
浆细胞	免疫球蛋白	Related-SY	健康的浆细胞产生免疫球蛋白，这是我们称之为抗体的复杂蛋白质
骨髓瘤细胞	异常免疫球蛋白	Related-SY	骨髓瘤细胞不会产生正常的功能性抗体，而是产生称为单克隆蛋白的异常免疫球蛋白
单克隆蛋白	抗感染能力降低	Related-SY	单克隆蛋白的产生导致抗感染能力降低
椎骨骨折	神经受压	Related-SY	因此椎骨骨折经常会导致神经受压
运动神经的丧失	瘫痪	Related-SY	运动神经的丧失会导致瘫痪
钙的分解	高钙血症	Related-SY	骨骼中钙的分解可导致高钙血症
高钙血症	肾衰竭	Related-SY	高钙血症和高水平的单克隆蛋白可严重影响肾脏，引起肾衰竭
骨髓瘤	正常血细胞的生长	Related-SY	当骨髓瘤在骨髓中生长时，抑制正常血细胞的生长
FISH测试	易位	Related-CH	通过FISH测试可以检测易位，缺失片段，额外片段和染色体丢失的存在。
病毒感染	血清水平升高	Related-SY	病毒感染等因素有时会导致血清水平升高
异常浆细胞堆积	骨髓瘤	Related-SY	这是异常浆细胞堆积导致骨髓瘤的组织。
细胞因子	其他细胞的生长	Related-TR	细胞因子可刺激或抑制其他细胞的生长/活性。
免疫系统	抗体	Related-SY	免疫系统产生抗体的细胞器官和细胞复合体，保护身体免受细菌，病毒，毒素和癌症等外来物质的细胞反应。
LDH	骨髓瘤活性	Related-CH	LDH可用于监测骨髓瘤活性
成骨细胞	类骨质	Related-SY	成骨细胞产生类骨质，钙化矿化形成新的硬骨。
恶性浆细胞	异常抗体	Related-SY	恶性浆细胞产生大量异常抗体。
高血钙	肾脏损害	Related-TR	高血钙，感染等因素也会造成或增加肾脏损害的严重程度。
放疗	骨破坏	Related-TR	放疗减轻骨破坏防止骨骼破坏的辐射
红细胞	贫血	Related-TR	输注红细胞缓解贫血
骨髓腔内溶骨性破坏	病理性骨折	Related-SY	由骨髓腔内溶骨性破坏引起的病理性骨折或严重骨痛（常在椎骨或肋骨内）是导致MM诊断的前哨事件
骨细胞活性	纯溶骨性病变	Related-SY	总的来说，这种不平衡的骨细胞活性导致纯溶骨性病变的发展
骨骼	病理性骨折	Related-CO	经常发生的骨骼相关并发症[通常统称为骨骼相关事件（SREs）]包括病理性骨折（特别是椎骨），难治性骨痛，高钙血症和脊髓压迫
肺气肿 肺心病 Related-CO 邻近肺组织常呈代偿性肺气肿，最后可并发肺心病和呼吸衰竭
脑梗塞 脑组织的缺血性坏死 Related-SY 脑梗塞是由于脑部血液供应障碍、缺血、缺氧引起的局限性脑组织的缺血性坏死或脑软化
肺气肿 呼吸衰竭 Related-CO 邻近肺组织常呈代偿性肺气肿，最后可并发肺心病和呼吸衰竭
甲亢 多食 Related-SY 甲亢的主要临床表现为多食、消瘦、畏热、多汗、心悸、激动等高代谢症候群，神经和血管兴奋增强，以及不同程度的甲状腺肿大和眼突、手颤、胫部血管杂音等为特征
甲亢 碘131放射 Related-TR 目前治疗甲亢主要有三种：药物、碘131放射治疗以及手术。
甲亢 甲功 Related-CH 甲亢最常用的是药物治疗，药物治疗需要的时间会比较长，用药期间定期复查甲功以及肝肾功、血常规等。